b,g,y,g,y,g,y,g,b
g,g,g,g,g,g,g,g,g
y,g,w,w,w,w,w,g,y
g,g,w,w,w,w,w,g,g
y,g,w,w,w,w,w,g,y
g,g,w,w,w,w,w,g,g
y,g,w,w,w,w,w,g,y
g,g,gr,g,gr,g,gr,g,g
r,r,r,r,r,r,r,r,r
